1111111111111111111111111111111111111111111111111111122222111111111111111111111111111111111111111111
1111111111111111111110000000001111111111111111111111220000000000001111111111111111111111111111111111
1111111111111111111110000000001111111111111111111222200222100000000111111111111111111111111111111111
1111111111111111111110000000001111111111111111112200002211100000000011111111111111111111111111111111
1111111111111111111100000000001111111111111111122002222111000000000011111111111111111111111111111111
1111111111111111111000000000000111111111111111220022111111000000000001111111111111111111111111111111
1111111111111111111000000000000111111111111112200221111111000000000000111111111111111111111111111111
1111111111111111111000000000000111111111111222002211111110000000000000111111111111111122211111111111
1111111111111111111000000000000011111111111200022111111100000000000000011111111111111120211111111111
1112222211111111110000000000000011111111111202221111111100000000000000001111111111111120211111111111
1112000211111111110000000000000011111111111222111111111000000000000000001111111111111120221111111111
1112000211111111100000000000000011111111111111111111111000000000000000000111111111111122021111111111
1112000211111111100000000000000011111111111111111111110000000000000000000011111111111112022111111111
1112202211111111000000000000000111111111111111111111100000000000000000000001111111111112002111111111
1111202111111111000000000000000111111111111111111111000000000000000000000000111111111112202211111111
1111202111111110000000000000000111111111111111111111000000000000000000000000111111111111200221111111
1112002111111000000000000000001111111111111111111110000000000000000000000000011111111111220022111111
1120021111100000000000000000011111111111111111111110000000000111111111000000001111111111122002211111
1120211110000000004000000000111111111111111111111100000000001111111111110000000111111111112200211111
1120211100000000000000000000111111111111111111111000000000111111111111111000000001111111111220211111
1120211000000000000000000011111111111111111111100000000000111111111111111000000000111111111120211111
1110100000000000000000000011111111111111111111000000000000111111111111111100000000000011111120211111
1100000000000000000000000011111111111111111000000000000000111111111111111100000000000000111220211111
1000000000000000000000000011111111111111110000000000000000111111111111111110000000000000012200211111
1000000000000000000000000011111111111111100000000000000000111111111111111110000000000000000002211111
1000000000000000000000000011111111111111100000000000000000011111111111111111000000000000001221111111
1000000000000000000000000011111111111111100000000000000000011111111111111111000000000000000111111111
1000000000000000000000000001111111111111100000000000000000001111111111111111100000000000000001111111
1000000000000000000000000001111111111111100000000000000000001111111111111111100000000000000000111111
1000000000000000000000000011111111111111100000000000000000001111111111111111110000000000000000011111
1000000000000000000000000011111111111111100000000000000000001111111111111111111000000000000000011111
1000000000000000000000000011111111111111100000000000000000011111111111111111111100000000000000011111
1000000000000000000000000111111111111111110000000000000000011111111111111111111100000000000000011111
1000000000000000000000000111111111111111110000000000000000111111111111111111111110000000000000011111
1000000000000000000000000111111111111111111000000000000001111111111111111111111111000000000000011111
1000000000000000000000000111111111111111111100000000000011111111111111111111111111000000000000111111
1000000000000000000000001111111111111111111100000000000111111111111111111111111111100000000001111111
1000000000000000000000011111111111111111111110000000011111111111111111111111111111110000000001111111
1000000000000000000000111111111111111111111111000001111111111111111111111111111111110000000001111111
1000000000000000000001111111111111111111111111100011111111111111111111111111111111111000000011111111
1000000000000000001111111111111111111111111111110011111111111111111111111111111111111000000011111111
1000000000000000011111111111111111111111111111110001111111111111111111111111111111111000000011111111
1100000000000000111111111111111111111111111111110001111111111111111111111111111111111100000011111111
1110000000000000111111111111111111111111111111110000111111111111111111111111111111111100000111111111
1111000000000000111111111111111111111111111111110000111111111111111111111111111111111100000111111111
1111000000000001111111111111111111111111111111110000011111111111111111111111111111111100000111111111
1111100000000001111111111111111000001111111111110000011111111111111111111111111111111100000111111111
1111110000000001111111111110000000000001111111110000001111111111111111111111111111111100000111111111
1111111000000001111111111100000000000000111111000000001111111111111111111111111111111100000111111111
1111111000000000111111111000000000000000001110000000000111111111111111111111111111111000000111111111
1111111100000000011111110000000000000000000000000000000111111111111111111111111111111000000111111111
1111111100000000011111100000000000000000000000000000000111111111111111111111111111111000000011111111
1111111110000000000000000000000000000000000000000000000111111111111111111111111111111000000011111111
1111111110000000000000000000000000000000000000000000000111111111111111111111111111110000000011111111
1111111110000000000000000000000000000000000000000000000111111111111111111111111111110000000001111111
1111111110000000000000000000000000000000000000000000000111111111111111111111111111110000000001111111
1111111110000000000000000000000000000000000000000000011111111111111111111111111111110000000001111111
1111111110000000000000000000000110000000000000000000011111111111111111111111111111100000000001111111
1111111111000000000000000000111111111000000000000000111111111111111111111111111111100000000001111111
1111111111000000000000000001111111111100000000000000111111111111111111111111111111100000000001111111
1111111111000000000000000111111111111110000000000001111111111111111111111111111111000000000000111111
1111111111000000000000000111111111111111000000000001111111111111111111111111111111000000000000111111
1111111111000000000000000111111111111111100000000001111111111111111111111111111110000000000000111111
1111111111000000000000000111111111111111100000000011111111111122211111111111111100000000000001111111
1111111122100000000000000111111111111111100000000111111111111220211111111111111000000000000001111111
1111112220000000000000000111111111111111100000001111111111111200211111111111110000000000000001111111
1111122000210000000000001111111111111111100000011111111111112202211111111111100000000000000011111111
1111220022211000000000001111111111111111110000011111111111112002111111111111000000000000000011111111
1111200221111100000000001111111111111111110000011111111111122022111111111111000000000000000012221111
1112202211111110000000001111111111111111110000001111111111120021111111111110000000000000000000021111
1122002111111110000000001111111111111111110000000111111111220221111111111110000000000000000012022111
1120022111111111000000001111111111111111110000000111111112200211111111111100000000000000000112002111
1220022111111111100000001111111111111111111000000011111112002211111111111100000000000000011112202111
1200022111111111110000000111111111111111111000000001111112021111111111111000000000000001111111202111
1202002111111111111000000111111111111111111100000000111112021111111111110000000000000011111111202111
1202202111111111111000000011111111111111111100000000011112021111111110000000000000000111111111202111
1202202211111111111000000011111111111111111110000000000011011111111100000000000000000111111111202111
1202200211111111111000000011111111111111111111000000000000011111110000000000000000000111111111202111
1222120221111111111000000001111111111111111111000000000000000000000000000000000000000111111122202111
1111120021111111111000000001111111111111111111100000000000000000000000000000000000001111111220002111
1111112022211111111000000000111111111111111111110000000011111111100000000000000000011111112200222111
1111112000211111110000000000011111111111111111111000000011112222211000000000000001111111122002211111
1111112220211111110000000000011111111111122211111100000011112000211000000000001111111111220022111111
1111111122211111110000000000001111111111120211111110000011117000211000000000011111111111200221111111
1111111111111111110000000000000111111111120211111111000011112000211000000000011111111111222211111111
1111111111111111110000000000000111111111120211111111100001112202211000000000011111111111111111111111
1111111111111111110000000000000011111111120211111111100000111202111000000000011111111111111111111111
1111111111111111110000000000000011111111120211111111110000011202110000000000011111111111111111111111
1111111111111111110000000000000001111111220211111111110000000101000000000000011111111111111111111111
1111111111111111100000000000000000111112200211111111111000000000000000000000011111111111111111111111
1111111111111111100000000000000000011122002211111111111100000000000000000000011111111111111111111111
1111111111111111100000000000000000001220022111111111111111000000000000000000011111111111111111111111
1111111111111111100000000000000000001200221111111111111111110000000000000000001111111111111111111111
1111111111111111100000000000000000000002211111111111111111111100000000000000001111111111111111111111
1111111111111111100000000000000000001222111111111111111111111111110000000000011111111111111111111111
1111111111111111100000000000000000001111111111111111111111111111111000000000011111111111111111111111
1111111111111111100000000000000000001111111111111111111111111111111100000000011111111111111111111111
1111111111111111100000000000000000011111111111111111111111111111111110000000001111111111111111111111
1111111111111111100000000000000000111111111111111111111111111111111111110000001111111111111111111111
1111111111111111111111111111111111111111111111111111111111111111111111111111111111111111111111111111