000000000000000000000000000000000000000000000000000000000000000000000000000000000000000000000000000000000000000000000000000000000000000000000000000000000000000000000000001111111000
000000000000000000000000000000000000000000000000000000000000000000000000000000000000000000000000000000000000000000000000000000000000000000000000000000000000000000000000011000001111
000000000000000000000000000000000000000000000000000000000000000000000000000000000000000000000000000000000000000000000111111111111111000000000000000000000000000000000001110000700001
000000111111111111111111111111000000000000000000000000000000000000000000000000000000000000000000000000000000000000011000000000000000111100000000000000000000000000000111000000000001
000001100000000000000000000001110000000000000000000000000000000000000000000000000000000000000000000000000000000000110000000000000000000011100000000000000000000000001100000000000111
000001000000000000000000000000011000000000000000000000000000000000000000000000000000000000000000000000000000000000100000600000000000000000011111111111110000000000011000000000011000
000001000000000000000000000000001100000000000000000000000000000000000000000000000000000000000000000000000000000000100000000000000000000000000000000000011111100000110000000000110000
000001100000000000000000000000000110000000000000000000000000000000000000000000000000000000000000000000000000000000100600000000000000000000000000000000000000111111990000000000100000
000000100000000000000000000000000011000000000000000000000000000000000000000000000000000000000000000000000000000000100000000000000000000000000000000000000000000000099900000001100000
000000011000000000000000000000000001000000000000000000000000000000000000000000000000000011111111110000000000000000100000000000000000000000000000000000000000000000000990000110000000
000000001111111100000000000000000000100000000000000000000000000000000000000000000000001110000000011100000000000000111111111111000000000000000000000000000000000000000099901100000000
000000000000000011110000000000000000110000000000000000000000000000000000000000000000011000000000000111000000000000000000000001111111111000000000000000000000000000000000911000000000
000000000000000000011100000000000000010000000000000000000000000000000000000000000001100000060006060001000000000000000000000000000000001111100000000000000000000000000000010000000000
00000000000000000000011100000000000001100000000000000000000000000000000000000000000100000000000000060110000000000000000000000000000000000011111111000000000000aaaa000000010000000000
0000000000000000000000011100000000000010000000000000000000000000000000000000000000100000000000606000001000000000000011111111111100000000000000000111100000000aa00aa00000010000000000
000000000000000000000000010000000000001100000000000000000000000000000000000000001100000000000000000000100000000000011000000000011111100000000000000011100000aa0000a00000010000000000
000000000000000000000000010000000000000110000000000000000000000000000000000000001000000000000000000000110000000000010000000000000000111111000000000000110000aa0000a00000010000000000
0000000000000000000000001100000000000000100000000000000000000000000000000000000100000000222222220000000100000000001100000000000000000000001100000000000010000aa000a00000010000000000
000000000000000000000000100000000000000011000000000000000000000000000000000000110000002210000022200000010000000000100000000000000000000000011000000000001100000aaaa00000001000000000
000000000000000000000001000000000000000001000000000000000000000000000000000000100000002100000000220000010000000000100000000000000000000600001000000000000100000000000000001000000000
000000000000000000000010000000000000000001100000000000000000000000000000000001100000002000000000020000010000000000100000000000000000000006001000000000000110000000000000001100000000
000000000000000000001100000000000000000000100000000000000000000000000000000001000000002000000000022000010000000000100000000000000000000000011000000000000010000000000000000100000000
000000000011111111111000000000000000000000100000000000000000000000000000000001000000002000000000002000001000000000100000000000000000000000110000000000000011000000000000000110000000
000000011110000000000000000000000000000000010000000000000000000000000000000010000000002000000000002200001000000001000000000000000000006011100000000000000001000000000000000010000000
000001110000000000000000000000000000000000010000000000000000000000000000000010000000002000000000001200001000000001000000000000000000000010000000000000000001000000000000000011000000
000001000000000000000000000000000000000000001000000000000000000000000000000100000000002000000000001200001000000001000000000022222222000110000000000000000001100000000000000001000000
000011000000000000000000000000000000000000000110000000000000000000000000001100000000002000000000002200001000000001000000002210000012200100000000000000000000100000000000000001000000
000010000000000000000000000000000000000000000011000000000000000000000000011000000000002000000000002000001000000001000000021100000002200100000000000000000000110000000000000001000000
000010000000000000000000000000000000000000000000110000000000000000000001100000000000002000000000022000001000000001000000021000000002201000000000000000000000010000000000000001100000
000100000000000000000000000000000000000000000000011100000000000000000011000000000000002210000000120000000100000001000000221000000002001000000000000000000000010000000000000000100000
000100000000000222000000000000000000000000000000000110000000000000000110000000000000000222110011220000000100000001000000211000000002011000000000000000000000010000000000000000100000
000100000000002202000000000000000000000000000000000011110000000000011000000000000000000002222222200000000100000001000000210000000002010000000000000000000000010000000000000000100000
000100000000022002000000000000000000000000000000000000001111110001110000022222222222222000000000000000000100000001000000210000000012010000000000000000000000010000000000000000100000
000100000002220002000000000000000000000000000000000000000000011111000022222000000000012222000000000000000100000001000000220000000012010000000000000000000000010000000000000000100000
000100000002000002000000000000000000000000000000000000000000000000000220000000000000000222222200000000000010000001000000022000000122010000000000000000000000010000000000000000100000
000100000002200002000000000000000000000000000000000000000000000000002200000000000000000000001222000000000010000001000000002200000220010000000111111110000000110000000000000000100000
000100000000222220000000002222000000000000000000000000000000000000022000000000000000000000000002222200000010000001000000000221112200010000011000000011111110100000000000000000100000
000100000000000000000000002002000000000000000000000000000000000000021000000000000000000000000000022220000010000001000000000022222000010000110000000000000011000000000000000000100000
000100000000000000000000020002200000000000000000000000000000000000020000000000000000000000000000000220000011000001000000000000000000011111100000000000000000000000000000000000100000
000100000000000000000000020000200000000000000000000000000000000000020000000001122222222221000000000022000001000001000000000000000000000000000000000000000000000000000000000000100000
000010000000000000000000220002200000000000000000000000000000000000020000000122200000000022221000000002200001000001000000000000000000000000000000022222200000000000000000000000100000
000010000000000000000000222222000000000000000000000000000000000000220000002200000000000000022100000002220001000001000000000000000000000000000000222200220000000000000000000001000000
000010000000000000000000000000000000000000000000000000000000000000200000002000600000000000002210000000220001000001000000000000000000000000000002200000022000000000000000000001000000
000011000000000000000000000000000000000111111110000000000000000000200000022060000000000000000211000000220000100001000000000000000000000000000222000000022000000000000000000001000000
000001000000000000000000000000000000011000000011000000000000000000200000020000000000000000000221000000022000100001000000000000000000000000000222000000022000000000000000000001000000
0000010000000000000000000000000000001100000000010000000000000000002000000200000000000aaaaaaa0022100000022000100001000000000000000000000000000220000000022000000000000000000001000000
00000010000000002220000000000000000110000000000100000000000000000020000002000000000aaa00001aa002210000002000100001000000000000000000000000002200000000022000000000000000000001000000
000000100000000020220000000000000111000000000001000000000000000000200000020600000aaaa0000000a000220000002200110011000000000000000000000000002000000000120000000000000000000001000000
000000100000002220022000000000001100000000000011000000000000000000200000120000000a0000000000aa00022000001200010010000000000000000000000000022000000001220000000000000000000011000000
00000010000002200000200000000001100000000000011000000000000000000022000022000000aa00000000000aa0002220001220011010000000000000000000000000020000000002200000000000000000000010000000
0000001000000200000020000000000100000000000011000000000000000000000220022000000aa0000000000000a0000222000120001010000000000000000000000000020000000022200000000000000000000010000000
0000001006006200000220000000001000000000001110000000000aaaa0000000002222000000aa0000000000000aa0000022200120001100000000000000000000000000220000000222000000000000000000000110000000
00000011000002000002000000000010000000000110000000000aaa00aa00000000000000000aa00000000000000aa0000002200022000000000000000000000000000002222000000220000000000000000000000100000000
0000000100600220000200000000001000000000110000000000aa00000aa000000000000000aa0000000000000aaa00000000210012000000000000000000000000000002222200002200000000000000000000000100000000
000000010000602222220000000001000000000010000000000aa0000000aaa00000000000aaa0000000000001aaa000000000222222000011111111111111000000000000221222222200000000000000000000001100000000
00000000100000000220000000000100000000011000000000aa0000000000aaaaaaaaaaaaa000000000000aaaa00000000000000000000110000000000001111111000000022222222000000000000000000000001000000000
00000000110600000000000000001100000000110000000000a00000000000000000000000000000000aaaaaa0000000000000000000011000000000000000000001111100000000000000000000000000000000010000000000
0000000001000000000000000001100000000010000000000aa00000000000000000000000000000aaaaaaa000000000000000000011110000000000000000000000000111000000000000000000000000000000010000000000
000000000110000000000000001100000000001000000000aa00000000000000000000000000aaaa0000000000000000000000111110000000000000000000000000000001100000000000000000000000000000110000000000
000000000001100000000000010000000000001000000000a00000000000000000aaaaaaaaaaa0000000000000000001111111100000000000000000000000000000000000011000000000000000000000000000100000000000
000000000000111100000011100000000000001000000000a00000000000000aaaa00000000000000000000000001111000000000000000000000000000000000000000000001110000000000000000000000001100000000000
000000000000000111111110000000000000001000000000aaa100000aaaaaa000000000000000000000000001111000000000000000000000000000000000000000000000000011000000000000000000000001000000000000
00000000000000000000000000000000000000100000000000aaaaaaaaaa000000000000000000000000001110000000000000000000000000000000000000000000000000000001110000000000000000000011000000000000
0000000000000000000000000000000000000010000000000000aaaaaaa0000000000000000000000111110000000000000000000000000000000000000000000000000000000000010000000000000000000110000000000000
00000000000000000000000000000000000000110000000000000a000000000000000000000111111000000000000000000000000000000000000000000000000000000000000000001000000000000006001100000000000000
000000000000000000000000000000000000000011000000000000000000000000000001111000000000000000000000000000000000000000000000000000000000000000000000000100000000000000011000000000000000
000000000000000000000000000000000000000001110000000000000000000000111110000000000000000000000000000000000000000000000000000000000000000000000000000010000000006001100000000000000000
000000000000000000000000000000000000000000011110000000000000000111100000000000000000000000000000000000000000000000000000000000000000000000000000000001100060000011000000000000000000
000000000000000000000000000000000000000000000001111111111111111000000000000000000000000000000000000000000000000000000000000000000000000000000000000000110000001110000000000000000000
000000000000000000000000000000000000000000000000000000000000000000000000000000000000000000000000000000000000000000000000000000000000000000000000000000011100111000000000000000000000
000000000000000000000000000000000000000000000000000000000000000000000000000000000000000000000000000000000000000000000000000000000000000000000000000000000011100000000000000000000000
000000000000000000000000000000000000000000000000000000000000000000000000000000000000000000000000000000000000000000000000000000000000000000000000000000000000000000000000000000000000
000000000000000000000000000000000000000000000000000000000000000000000000000000000000000000000000000000000000000000000000000000000000000000000000000000000000000000000000000000000000
000000000000000000000000000000000000000000000000000000000000000000000000000000000000000000000000000000000000000000000000000000000000000000000000000000000000000000000000000000000000
000000000000000000000000000000000000000000000000000000000000000000000000000000000000000000000000000000000000000000000000000000000000000000000000000000000000000000000000000000000000
000000000000000000000000000000000000000000000000000000000000000000000000000000000000000000000000000000000000000000000000000000000000000000000000000000000000000000000000000000000000
000000000000000000000000000000000000000000000000000000000000000000000000000000000000000000000000000000000000000000000000000000000000000000000000000000000000000000000000000000000000
000000000000000000000000000000000000000000000000000000000000000000000000000000000000000000000000000000000000000000000000000000000000000000000000000000000000000000000000000000000000
000000000000000000000000000000000000000000000000000000000000000000000000000000000000000000000000000000000000000000000000000000000000000000000000000000000000000000000000000000000000
000000000000000000000000000000000000000000000000000000000000000000000000000000000000000000000000000000000000000000000000000000000000000000000000000000000000000000000000000000000000
000000000000000000000000000000000000000000000000000000000000000000000000000000000000000000000000000000000000000000000000000000000000000000000000000000000000000000000000000000000000
