11111111111111
10100010001000
10101010101011
10101010101011
10101010101011
10101010101011
10101010101011
10101010101011
10101010101011
10101010101011
10101010101011
10001000100011
11111111111111